22222222222222222222
20000000000000000002
20000000000000000002
20010010020001100002
20001100020001100002
20001100020000000002
20010010020000000002
20000000022220000002
20000000020000001002
22222222220000011002
20000000000000111002
20000000000000000002
20010002000000000002
20011002222222222222
20010000000000000002
20000000000000000002
20000001100110011002
20000000000000000002
20000000000000000002
22222222222222222222