22222222222222222222
20000000000000000012
20000000000000000102
20022222222222222002
20021000000000002002
20020100000000002002
20020022200222002002
20020020000002002002
20020020000002002002
20000020011002000002
20000020011002000002
20020020000002002002
20020020000002002002
20020022200222002002
20020000000000102002
20020000000000012002
20022222222222222002
20100000000000000002
21000000000000000002
22222222222222222222